#######
#O#   #
# # # #
# # # #
#   # E
#######